...................................................................................................................................................................................................................................................................................................................................................................................
...................................................................................................................................................................................................................................................................................................................................................................................
...................................................................................................................................................................................................................................................................................................................................................................................
...................................................................................................................................................................................................................................................................................................................................................................................
...................................................................................................................................................................................................................................................................................................................................................................................
...................................................................................................-..............................................................................................................................................................................................-................................................................................
.................................................>............................................................................>....................................................................................................................................................................................................................................................
...............................................................................................-...................................................................................................................................................................................................................................................................................
........>.........................-.............................................................................................-..................................................................................................................................................................................................................................................
.............................................-.............................................>...........>....................-........-..........................................-........................>........................................-.........................>......................................................................................................
....................................^............................................................^....................................................................................-..........>..........................................>-..........................-......................-...........-.......................................................................
####=....=######################=.....==....>.....=###################################=.....^...........=###############=.....==.....>..=#################################=.^........>...=###=.....-.......=###########################=.............=########=...=###=........=##########=...>.......-...>..=##################################################################...
..........................................................................................................................^..........................................................................^.........................................^................^............^....................-^...............................................................................
.....AAAA........................AAAAA..AAAAAAAAAA.....................................AAAAAAAAAAAAAAAAA.................AAAAA..AAAAAAAA...................................AAAAAAAAAAAAAA.....AAAAAAAAAAAAA.............................AAAAAAAAAAAAA..........AAA.....AAAAAAA..............AAAAAAAAAAAAAAAAA......................................................................
+++++++++++++++++++++++++++++++++++++++++++++++++++++++++++++++++++++++++++++++++++++++++++++++++++++++++++++++++++++++++++++++++++++++++++++++++++++++++++++++++++++++++++++++++++++++++++++++++++++++++++++++++++++++++++++++++++++++++++++++++++++++++++++++++++++++++++++++++++++++++++++++++++++++++++++++++++++++++++++++++++++++++++++++++++++++++++++++++++++++++++++++++++